....................
....................
....................
@@@@@@@@@...........
....................
....................
....................
....................
....................
....................
....................
....................
....................
......#####.........
....................
..#####.............
.............#####..
@@@@@@@@@@@@@@@@@@@@