....................
....................
....................
@@@@@@@@@...........
....................
....................
....................
....................
....................
..............##....
...............#....
...............#....
...............#....
...............#....
...........#####....
..#####.............
.............#####..
@@@@@@@@@@@@@@@@@@@@